#######
#	 ####
#O @       @  O #
###A 	 #####
###@	 #
###O	 #
########